VacationFilterItemModel=ctrip.business.travel.model.VacationFilterItemModel
FlightInfoInListModel=ctrip.business.intFlight.model.FlightInfoInListModel
BasicCoordinateModel=ctrip.business.hotel.model.BasicCoordinateModel
PackageFlightListSearchResponse=ctrip.business.selfTravel.PackageFlightListSearchResponse
CustomerUserIdCardDeleteResponse=ctrip.business.system.CustomerUserIdCardDeleteResponse
RoomDetailModel=ctrip.business.hotel.model.RoomDetailModel
HotelSevenDayRoomAvailCheckResponse=ctrip.business.hotel.HotelSevenDayRoomAvailCheckResponse
OtherServiceItemModel=ctrip.business.other.model.OtherServiceItemModel
PkgOrderFlightDetailInformationModel=ctrip.business.selfTravel.model.PkgOrderFlightDetailInformationModel
HotelOrderSubmitResponse=ctrip.business.hotel.HotelOrderSubmitResponse
BasicItemSettingModel=ctrip.business.hotel.model.BasicItemSettingModel
RoomBasicInfoEntityModel=ctrip.business.hotel.model.RoomBasicInfoEntityModel
CarPriceTypeModel=ctrip.business.carProduct.model.CarPriceTypeModel
PushMessageModel=ctrip.business.flight.model.PushMessageModel
PkgAirportInformationModel=ctrip.business.selfTravel.model.PkgAirportInformationModel
PriceInfoInListModel=ctrip.business.intFlight.model.PriceInfoInListModel
OtherDistrictSummaryModel=ctrip.business.other.model.OtherDistrictSummaryModel
PlaceModel=ctrip.business.hotel.model.PlaceModel
GroupContentModel=ctrip.business.hotelGroup.model.GroupContentModel
OtherIntlCityDataSynchronizeResponse=ctrip.business.other.OtherIntlCityDataSynchronizeResponse
TrainBookingCheckResponse=ctrip.business.train.TrainBookingCheckResponse
VacationCommentSearchResponse=ctrip.business.travel.VacationCommentSearchResponse
HotelCityListSearchResponse=ctrip.business.overseas.HotelCityListSearchResponse
GroupOrderSubmitResponse=ctrip.business.hotelGroup.GroupOrderSubmitResponse
PkgHotelDetailRoomInformationModel=ctrip.business.selfTravel.model.PkgHotelDetailRoomInformationModel
OtherVacationProductDataSynchronizeResponse=ctrip.business.other.OtherVacationProductDataSynchronizeResponse
GroupCommentListSearchResponse=ctrip.business.hotelGroup.GroupCommentListSearchResponse
HotelCityModel=ctrip.business.overseas.model.HotelCityModel
VacationProductDetailSearchResponse=ctrip.business.travel.VacationProductDetailSearchResponse
OtherPushMessageItemModel=ctrip.business.other.model.OtherPushMessageItemModel
GroupRoomStatusSearchResponse=ctrip.business.hotelGroup.GroupRoomStatusSearchResponse
VacationProductItemModel=ctrip.business.travel.model.VacationProductItemModel
IntlFlightOrderDetailSearchResponse=ctrip.business.intFlight.IntlFlightOrderDetailSearchResponse
OtherZoneInforSearchResponse=ctrip.business.other.OtherZoneInforSearchResponse
AttentionAirLineModel=ctrip.business.flight.model.AttentionAirLineModel
TicketGiftModel=ctrip.business.hotel.model.TicketGiftModel
PackageDeliveryTypeSearchResponse=ctrip.business.selfTravel.PackageDeliveryTypeSearchResponse
OrderProductItemModel=ctrip.business.travel.model.OrderProductItemModel
PkgSegmentDetailInformationModel=ctrip.business.selfTravel.model.PkgSegmentDetailInformationModel
CustomerFacilityModel=ctrip.business.system.model.CustomerFacilityModel
TrainInsuranceItemModel=ctrip.business.train.model.TrainInsuranceItemModel
PkgProProductInformationModel=ctrip.business.selfTravel.model.PkgProProductInformationModel
StrategyConfigItemModel=ctrip.business.flight.model.StrategyConfigItemModel
OtherAirportCityDataSynchronizeResponse=ctrip.business.other.OtherAirportCityDataSynchronizeResponse
ProductImageItemModel=ctrip.business.travel.model.ProductImageItemModel
HotelSevenDayRegisterResponse=ctrip.business.hotel.HotelSevenDayRegisterResponse
OtherSubnetMaskSearchResponse=ctrip.business.other.OtherSubnetMaskSearchResponse
OtherHotelHotDataSynchronizeModel=ctrip.business.other.model.OtherHotelHotDataSynchronizeModel
CustomerCreditCardSearchResponse=ctrip.business.system.CustomerCreditCardSearchResponse
FlightModel=ctrip.business.intFlight.model.FlightModel
PushLoginningResponse=ctrip.business.other.PushLoginningResponse
FlightSubwayInformationModel=ctrip.business.airportInfo.model.FlightSubwayInformationModel
FlightAirlineInformationModel=ctrip.business.airportInfo.model.FlightAirlineInformationModel
VacationCommentCommitResponse=ctrip.business.travel.VacationCommentCommitResponse
InvoiceModel=ctrip.business.carProduct.model.InvoiceModel
FlightTicketInfoModel=ctrip.business.flight.model.FlightTicketInfoModel
TrainPassengerItemModel=ctrip.business.train.model.TrainPassengerItemModel
GroupCityInfoModel=ctrip.business.hotelGroup.model.GroupCityInfoModel
HotelCommentSubmitResponse=ctrip.business.hotel.HotelCommentSubmitResponse
RoomInfoNewEntityModel=ctrip.business.hotel.model.RoomInfoNewEntityModel
TrainOrderListSearchResponse=ctrip.business.train.TrainOrderListSearchResponse
CustomerVOIPSearchResponse=ctrip.business.basic.CustomerVOIPSearchResponse
BasicDeliveryInformationModel=ctrip.business.selfTravel.model.BasicDeliveryInformationModel
CarRentalOrderDetailResponse=ctrip.business.carProduct.CarRentalOrderDetailResponse
HotelOrderCancelResponse=ctrip.business.hotel.HotelOrderCancelResponse
IntlAirlineModel=ctrip.business.intFlight.model.IntlAirlineModel
DepartureCitySearchResponse=ctrip.business.carProduct.DepartureCitySearchResponse
DeliverInfoInOrderDetailModel=ctrip.business.intFlight.model.DeliverInfoInOrderDetailModel
CustomerCashSearchResponse=ctrip.business.system.CustomerCashSearchResponse
CustomerAddressOperateResponse=ctrip.business.system.CustomerAddressOperateResponse
HotelBasicInfoEntityModel=ctrip.business.hotel.model.HotelBasicInfoEntityModel
ActionLogAddResponse=ctrip.business.other.ActionLogAddResponse
CarBookingRuleItemModel=ctrip.business.carProduct.model.CarBookingRuleItemModel
HotelSevenDayMemberCheckResponse=ctrip.business.hotel.HotelSevenDayMemberCheckResponse
VacationTicketListSearchResponse=ctrip.business.travel.VacationTicketListSearchResponse
FlightInDetailModel=ctrip.business.intFlight.model.FlightInDetailModel
HotelActiveInformationModel=ctrip.business.hotel.model.HotelActiveInformationModel
FlightInfoInOrderDetailModel=ctrip.business.intFlight.model.FlightInfoInOrderDetailModel
OtherSubnetMaskDataSynchronizeModel=ctrip.business.other.model.OtherSubnetMaskDataSynchronizeModel
PkgVacationUseDateModel=ctrip.business.selfTravel.model.PkgVacationUseDateModel
FlightVarSearchResponse=ctrip.business.flight.FlightVarSearchResponse
PriceInformatonModel=ctrip.business.hotel.model.PriceInformatonModel
PackageDetailSearchResponse=ctrip.business.selfTravel.PackageDetailSearchResponse
PkgProRoomListInformationModel=ctrip.business.selfTravel.model.PkgProRoomListInformationModel
VoiceSearchResponse=ctrip.business.basic.VoiceSearchResponse
OtherServiceSearchResponse=ctrip.business.other.OtherServiceSearchResponse
CustomerIDCardItemModel=ctrip.business.system.model.CustomerIDCardItemModel
KeyForThirdPayInfoModel=ctrip.business.flight.model.KeyForThirdPayInfoModel
OtherUserModifyResponse=ctrip.business.other.OtherUserModifyResponse
BasicPassengerModel=ctrip.business.selfTravel.model.BasicPassengerModel
CheckFavHotelResponse=ctrip.business.hotel.CheckFavHotelResponse
FlightOrderSubmitResponse=ctrip.business.flight.FlightOrderSubmitResponse
FlightSearchSettingModel=ctrip.business.baiscModel.model.FlightSearchSettingModel
VacationOrderSubmitResponse=ctrip.business.travel.VacationOrderSubmitResponse
HotelOrderCreateResponse=ctrip.business.overseas.HotelOrderCreateResponse
VacationProductEmailShareResponse=ctrip.business.travel.VacationProductEmailShareResponse
OtherEncryptionKeyGetResponse=ctrip.business.other.OtherEncryptionKeyGetResponse
TicketSpecialServiceModel=ctrip.business.flight.model.TicketSpecialServiceModel
BaseDataActionModel=ctrip.business.other.model.BaseDataActionModel
FlightBaseInfoInListModel=ctrip.business.intFlight.model.FlightBaseInfoInListModel
FlightInOrderDetailModel=ctrip.business.intFlight.model.FlightInOrderDetailModel
InvoiceInfoInOrderSubmitModel=ctrip.business.intFlight.model.InvoiceInfoInOrderSubmitModel
BasicOrderCancelResponse=ctrip.business.basic.BasicOrderCancelResponse
FlightFullIntervalModel=ctrip.business.flight.model.FlightFullIntervalModel
HotelRoomTotalPriceModel=ctrip.business.overseas.model.HotelRoomTotalPriceModel
PackageOrderCreateResponse=ctrip.business.selfTravel.PackageOrderCreateResponse
HotelBasicInformationModel=ctrip.business.hotel.model.HotelBasicInformationModel
CommonSocketSettingModel=ctrip.business.other.model.CommonSocketSettingModel
OtherTrainStationDataSynchronizeModel=ctrip.business.other.model.OtherTrainStationDataSynchronizeModel
GroupProductModel=ctrip.business.hotelGroup.model.GroupProductModel
NearbyFacilityModel=ctrip.business.hotel.model.NearbyFacilityModel
IntlFlightOrderSubmitResponse=ctrip.business.intFlight.IntlFlightOrderSubmitResponse
FlightCabinDetailModel=ctrip.business.flight.model.FlightCabinDetailModel
ProfessionItemModel=ctrip.business.travel.model.ProfessionItemModel
BasicTinyImageModel=ctrip.business.selfTravel.model.BasicTinyImageModel
CustomerTravelTicketModel=ctrip.business.system.model.CustomerTravelTicketModel
PolicyInfoInOrderDetailModel=ctrip.business.intFlight.model.PolicyInfoInOrderDetailModel
UserTravelSearchResponse=ctrip.business.basic.UserTravelSearchResponse
VacationProductVisaDetailSearchResponse=ctrip.business.travel.VacationProductVisaDetailSearchResponse
GroupCityListSearchResponse=ctrip.business.hotelGroup.GroupCityListSearchResponse
OtherNonmemberRegisterResponse=ctrip.business.other.OtherNonmemberRegisterResponse
OutlandHotelOrderInfoLoadResponse=ctrip.business.hotel.OutlandHotelOrderInfoLoadResponse
CustomerPayOutModel=ctrip.business.system.model.CustomerPayOutModel
PkgOrderHotelDetailInformationModel=ctrip.business.selfTravel.model.PkgOrderHotelDetailInformationModel
ReturnTicketRuleModel=ctrip.business.train.model.ReturnTicketRuleModel
PkgFltFlightSubClassInformationModel=ctrip.business.selfTravel.model.PkgFltFlightSubClassInformationModel
HotelCommentInfoEntityModel=ctrip.business.hotel.model.HotelCommentInfoEntityModel
MessagePushingResponse=ctrip.business.other.MessagePushingResponse
CustomerCashRefundModel=ctrip.business.system.model.CustomerCashRefundModel
FlightVarDetailItemModel=ctrip.business.flight.model.FlightVarDetailItemModel
TrainTimetableListSearchResponse=ctrip.business.train.TrainTimetableListSearchResponse
CurrentPosotionEntityModel=ctrip.business.hotel.model.CurrentPosotionEntityModel
PkgProFlightListInformationModel=ctrip.business.selfTravel.model.PkgProFlightListInformationModel
FlightLowestPriceSearchResponse=ctrip.business.flight.FlightLowestPriceSearchResponse
HotelTinyPriceModel=ctrip.business.hotel.model.HotelTinyPriceModel
PassengerEntityModel=ctrip.business.flight.model.PassengerEntityModel
VacationProductStartingPriceListSearchResponse=ctrip.business.travel.VacationProductStartingPriceListSearchResponse
TicketPaymentModel=ctrip.business.flight.model.TicketPaymentModel
FlightAirportSvrPhoneInformationModel=ctrip.business.airportInfo.model.FlightAirportSvrPhoneInformationModel
OtherZoneInforModel=ctrip.business.other.model.OtherZoneInforModel
CustomerNoticeItemModel=ctrip.business.system.model.CustomerNoticeItemModel
PassBookInfoModel=ctrip.business.flight.model.PassBookInfoModel
CoordinateItemModel=ctrip.business.hotel.model.CoordinateItemModel
CustomerUsedModel=ctrip.business.system.model.CustomerUsedModel
OtherPasswordChangeResponse=ctrip.business.other.OtherPasswordChangeResponse
CustomerTicketVerifyResponse=ctrip.business.system.CustomerTicketVerifyResponse
CustomerCreditCardCheckResponse=ctrip.business.system.CustomerCreditCardCheckResponse
OtherCraftTypeDataSynchronizeModel=ctrip.business.other.model.OtherCraftTypeDataSynchronizeModel
PaymentListSearchResponse=ctrip.business.payment.PaymentListSearchResponse
CustomerAddressItemModel=ctrip.business.system.model.CustomerAddressItemModel
VacationSeasonSearchResponse=ctrip.business.travel.VacationSeasonSearchResponse
PromotionModel=ctrip.business.travel.model.PromotionModel
FlightVarDetailSearchResponse=ctrip.business.flight.FlightVarDetailSearchResponse
OtherPasswordGetResponse=ctrip.business.other.OtherPasswordGetResponse
VacationOrderReturnResponse=ctrip.business.travel.VacationOrderReturnResponse
GroupHotelListSearchResponse=ctrip.business.hotelGroup.GroupHotelListSearchResponse
CarRentalSearchResponse=ctrip.business.carProduct.CarRentalSearchResponse
ThirdPartyInformationModel=ctrip.business.payment.model.ThirdPartyInformationModel
IntlFlightDetailSearchResponse=ctrip.business.intFlight.IntlFlightDetailSearchResponse
DeliveryTypeInformationModel=ctrip.business.selfTravel.model.DeliveryTypeInformationModel
CommentQuestionModel=ctrip.business.travel.model.CommentQuestionModel
FlightDetailNoteModel=ctrip.business.flight.model.FlightDetailNoteModel
FlightEntityModel=ctrip.business.flight.model.FlightEntityModel
BusinessDataSearchModel=ctrip.business.hotel.model.BusinessDataSearchModel
VacationCruiseLineSearchResponse=ctrip.business.travel.VacationCruiseLineSearchResponse
BranchItemModel=ctrip.business.hotel.model.BranchItemModel
FlightLowPriceSearchResponse=ctrip.business.flight.FlightLowPriceSearchResponse
CustomerCouponSearchResponse=ctrip.business.system.CustomerCouponSearchResponse
OtherUserRegisterResponse=ctrip.business.other.OtherUserRegisterResponse
OrderModel=ctrip.business.intFlight.model.OrderModel
TravelOrderInformationModel=ctrip.business.basic.model.TravelOrderInformationModel
TravelerItemModel=ctrip.business.travel.model.TravelerItemModel
HotelBrandListSearchResponse=ctrip.business.hotel.HotelBrandListSearchResponse
HotelRoomTicketGiftModel=ctrip.business.overseas.model.HotelRoomTicketGiftModel
RebateInfoModel=ctrip.business.travel.model.RebateInfoModel
BasicPassengerSettingModel=ctrip.business.baiscModel.model.BasicPassengerSettingModel
TrainInsuranceModel=ctrip.business.train.model.TrainInsuranceModel
TravelTrainInfoModel=ctrip.business.basic.model.TravelTrainInfoModel
HotelRoomPriceListSearchResponse=ctrip.business.overseas.HotelRoomPriceListSearchResponse
GroupHotelModel=ctrip.business.hotelGroup.model.GroupHotelModel
FlightPreBookingResponse=ctrip.business.flight.FlightPreBookingResponse
HotelFavorListSearchResponse=ctrip.business.hotel.HotelFavorListSearchResponse
HotelRoomBookingCheckResponse=ctrip.business.hotel.HotelRoomBookingCheckResponse
HotelHotListSearchResponse=ctrip.business.hotel.HotelHotListSearchResponse
PayInfoInOrderDetailModel=ctrip.business.intFlight.model.PayInfoInOrderDetailModel
HotelBeenListSearchResponse=ctrip.business.hotel.HotelBeenListSearchResponse
ChildPolicyModel=ctrip.business.flight.model.ChildPolicyModel
SupplymentModel=ctrip.business.flight.model.SupplymentModel
GroupActivityModel=ctrip.business.hotelGroup.model.GroupActivityModel
HotelListSearchResponse=ctrip.business.hotel.HotelListSearchResponse
BasicSendAddressModel=ctrip.business.baiscModel.model.BasicSendAddressModel
FlightSpeedySettingInfoModel=ctrip.business.flight.model.FlightSpeedySettingInfoModel
HotelAddInfoEntityModel=ctrip.business.hotel.model.HotelAddInfoEntityModel
HotHotelRoomModel=ctrip.business.hotel.model.HotHotelRoomModel
GroupHotelRouteModel=ctrip.business.hotelGroup.model.GroupHotelRouteModel
OtherClientIDGenerateResponse=ctrip.business.other.OtherClientIDGenerateResponse
BabyPolicyModel=ctrip.business.flight.model.BabyPolicyModel
CustomerFlightItemModel=ctrip.business.system.model.CustomerFlightItemModel
PassengerInOrderDetailModel=ctrip.business.intFlight.model.PassengerInOrderDetailModel
PkgVacationXInformationModel=ctrip.business.selfTravel.model.PkgVacationXInformationModel
OtherForTestResponse=ctrip.business.other.OtherForTestResponse
GroupDetailSearchResponse=ctrip.business.hotelGroup.GroupDetailSearchResponse
OtherUserInformationModel=ctrip.business.other.model.OtherUserInformationModel
OtherShortMessageSendResponse=ctrip.business.other.OtherShortMessageSendResponse
ContactInfoInOrderDetailModel=ctrip.business.intFlight.model.ContactInfoInOrderDetailModel
HotelRoomBasicInfoModel=ctrip.business.overseas.model.HotelRoomBasicInfoModel
FlightDetailInforItemModel=ctrip.business.flight.model.FlightDetailInforItemModel
HotelRoomImageModel=ctrip.business.overseas.model.HotelRoomImageModel
TravelFlightInformationModel=ctrip.business.basic.model.TravelFlightInformationModel
OtherHotelHotMetroDataSynchronizeResponse=ctrip.business.other.OtherHotelHotMetroDataSynchronizeResponse
OtherIntlCityDataSynchronizeModel=ctrip.business.other.model.OtherIntlCityDataSynchronizeModel
PkgFltSegmentListInformationModel=ctrip.business.selfTravel.model.PkgFltSegmentListInformationModel
HotelStaticInfoEntityModel=ctrip.business.hotel.model.HotelStaticInfoEntityModel
VacationNearbyTripTeamOrderSubmitResponse=ctrip.business.travel.VacationNearbyTripTeamOrderSubmitResponse
CustomerNoticeSearchResponse=ctrip.business.system.CustomerNoticeSearchResponse
GroupRoomStatusModel=ctrip.business.hotelGroup.model.GroupRoomStatusModel
FlightCloseSearchResponse=ctrip.business.flight.FlightCloseSearchResponse
TicketOptionItemModel=ctrip.business.travel.model.TicketOptionItemModel
CustomerFlightOrderModel=ctrip.business.system.model.CustomerFlightOrderModel
CustomerPreFlightItemModel=ctrip.business.flight.model.CustomerPreFlightItemModel
FlightTicketChangeResponse=ctrip.business.flight.FlightTicketChangeResponse
BasicInvoiceInformationModel=ctrip.business.selfTravel.model.BasicInvoiceInformationModel
FlightOrderItemModel=ctrip.business.flight.model.FlightOrderItemModel
CustomerNonTravelOrderSearchResponse=ctrip.business.system.CustomerNonTravelOrderSearchResponse
AnswerItemModel=ctrip.business.travel.model.AnswerItemModel
HotelServiceItemModel=ctrip.business.hotel.model.HotelServiceItemModel
PkgOrderSegmentDetailInformationModel=ctrip.business.selfTravel.model.PkgOrderSegmentDetailInformationModel
FlightThirdPayUpdateResponse=ctrip.business.flight.FlightThirdPayUpdateResponse
VacationTicketDetailSearchResponse=ctrip.business.travel.VacationTicketDetailSearchResponse
TaxiCostRefInformationModel=ctrip.business.airportInfo.model.TaxiCostRefInformationModel
OtherFlightSummaryModel=ctrip.business.other.model.OtherFlightSummaryModel
HotelRoomRemarkModel=ctrip.business.overseas.model.HotelRoomRemarkModel
VacationProductCommentListSearchResponse=ctrip.business.travel.VacationProductCommentListSearchResponse
HotelSearchCityModel=ctrip.business.overseas.model.HotelSearchCityModel
PkgRoomPriceInformationModel=ctrip.business.selfTravel.model.PkgRoomPriceInformationModel
HotelPicModel=ctrip.business.hotel.model.HotelPicModel
FlightSpeedyOperateResponse=ctrip.business.flight.FlightSpeedyOperateResponse
PkgProSegmentListInformationModel=ctrip.business.selfTravel.model.PkgProSegmentListInformationModel
FlightPreBookingResultSearchResponse=ctrip.business.flight.FlightPreBookingResultSearchResponse
ProductTicketItemModel=ctrip.business.travel.model.ProductTicketItemModel
VacationOrderListSearchResponse=ctrip.business.travel.VacationOrderListSearchResponse
TrainListSearchResponse=ctrip.business.train.TrainListSearchResponse
TicketInformationModel=ctrip.business.payment.model.TicketInformationModel
OtherZoneInforDataModel=ctrip.business.other.model.OtherZoneInforDataModel
SeatItemInforModel=ctrip.business.train.model.SeatItemInforModel
FlightSpeedyOrderSubmitResponse=ctrip.business.flight.FlightSpeedyOrderSubmitResponse
HotelNearbySearchResponse=ctrip.business.hotel.HotelNearbySearchResponse
HotelpPlaceInformationModel=ctrip.business.hotel.model.HotelpPlaceInformationModel
OtherHotelHotMetroDataSynchronizeModel=ctrip.business.other.model.OtherHotelHotMetroDataSynchronizeModel
FlightInfoInDetailModel=ctrip.business.intFlight.model.FlightInfoInDetailModel
CustomerPassengerOperateResponse=ctrip.business.system.CustomerPassengerOperateResponse
FlightBusInformationModel=ctrip.business.airportInfo.model.FlightBusInformationModel
BasicDeliveryAddressModel=ctrip.business.baiscModel.model.BasicDeliveryAddressModel
BasicFilterSettingModel=ctrip.business.baiscModel.model.BasicFilterSettingModel
GroupCouponModel=ctrip.business.hotelGroup.model.GroupCouponModel
OtherNationDataSynchronizeResponse=ctrip.business.other.OtherNationDataSynchronizeResponse
LowestPriceModel=ctrip.business.flight.model.LowestPriceModel
CustomerNearbyAutoNaviSearchResponse=ctrip.business.system.CustomerNearbyAutoNaviSearchResponse
BasicCreditCardItemModel=ctrip.business.hotel.model.BasicCreditCardItemModel
FavorHotelModel=ctrip.business.hotel.model.FavorHotelModel
OtherMessageGenerateResponse=ctrip.business.other.OtherMessageGenerateResponse
SyncBussinessDataSearchResponse=ctrip.business.other.SyncBussinessDataSearchResponse
GroupAdditionalModel=ctrip.business.hotelGroup.model.GroupAdditionalModel
PackageOrderListSearchResponse=ctrip.business.selfTravel.PackageOrderListSearchResponse
OrderItemInforModel=ctrip.business.train.model.OrderItemInforModel
SubBaseDataModel=ctrip.business.other.model.SubBaseDataModel
PkgRoomDetailFailityInformationModel=ctrip.business.selfTravel.model.PkgRoomDetailFailityInformationModel
RecommendHotelModel=ctrip.business.hotel.model.RecommendHotelModel
HotHotelModel=ctrip.business.hotel.model.HotHotelModel
FlightSubClassItemModel=ctrip.business.flight.model.FlightSubClassItemModel
OtherCityDataSynchronizeModel=ctrip.business.other.model.OtherCityDataSynchronizeModel
FareRemarkInDetailModel=ctrip.business.intFlight.model.FareRemarkInDetailModel
CustomerAirportWeatherModel=ctrip.business.flight.model.CustomerAirportWeatherModel
TrainTicketDetailSearchResponse=ctrip.business.train.TrainTicketDetailSearchResponse
FlightVarAttendResponse=ctrip.business.flight.FlightVarAttendResponse
TrainOrderCreateV2Response=ctrip.business.train.TrainOrderCreateV2Response
CountryItemModel=ctrip.business.travel.model.CountryItemModel
OtherClientLogAddResponse=ctrip.business.other.OtherClientLogAddResponse
ProductContentItemModel=ctrip.business.travel.model.ProductContentItemModel
NetQuantitySettingModel=ctrip.business.other.model.NetQuantitySettingModel
VacationFilterValueItemModel=ctrip.business.travel.model.VacationFilterValueItemModel
BasicStringModel=ctrip.business.selfTravel.model.BasicStringModel
PkgFlightDetailInformationModel=ctrip.business.selfTravel.model.PkgFlightDetailInformationModel
PriceInfoInDetailModel=ctrip.business.intFlight.model.PriceInfoInDetailModel
TrainOrderCreateResponse=ctrip.business.train.TrainOrderCreateResponse
CommentDetailModel=ctrip.business.hotel.model.CommentDetailModel
OtherCraftTypeDataSynchronizeResponse=ctrip.business.other.OtherCraftTypeDataSynchronizeResponse
PackageOrderDetailSearchResponse=ctrip.business.selfTravel.PackageOrderDetailSearchResponse
CustomerExpiredModel=ctrip.business.system.model.CustomerExpiredModel
PaymentSubmitSearchResponse=ctrip.business.payment.PaymentSubmitSearchResponse
PkgHotelDetailInformationModel=ctrip.business.selfTravel.model.PkgHotelDetailInformationModel
CarProductModel=ctrip.business.carProduct.model.CarProductModel
TinyOrderInfoModel=ctrip.business.flight.model.TinyOrderInfoModel
FlightBuckleUpPaySubmitResponse=ctrip.business.flight.FlightBuckleUpPaySubmitResponse
FlightInforItemModel=ctrip.business.flight.model.FlightInforItemModel
DeliveryInformationModel=ctrip.business.train.model.DeliveryInformationModel
InsuranceInfoInDetailModel=ctrip.business.intFlight.model.InsuranceInfoInDetailModel
FlightDeliveryAddressItemModel=ctrip.business.flight.model.FlightDeliveryAddressItemModel
FlightSpeedySettingDeliveryInfoModel=ctrip.business.flight.model.FlightSpeedySettingDeliveryInfoModel
CreditCardInfoInOrderSubmitModel=ctrip.business.intFlight.model.CreditCardInfoInOrderSubmitModel
OtherCantonDataSynchronizeModel=ctrip.business.other.model.OtherCantonDataSynchronizeModel
PayInfoEntityModel=ctrip.business.flight.model.PayInfoEntityModel
PkgOrderListInformationModel=ctrip.business.selfTravel.model.PkgOrderListInformationModel
XXXXXXResponse=ctrip.business.baiscModel.XXXXXXResponse
VacationProductImageListSearchResponse=ctrip.business.travel.VacationProductImageListSearchResponse
PkgOrderDetailInformationModel=ctrip.business.selfTravel.model.PkgOrderDetailInformationModel
CouponItemModel=ctrip.business.hotel.model.CouponItemModel
OtherUpdateCheckResponse=ctrip.business.other.OtherUpdateCheckResponse
FlightStopCityItemModel=ctrip.business.flight.model.FlightStopCityItemModel
CruiseLineModel=ctrip.business.travel.model.CruiseLineModel
AirPortModel=ctrip.business.carProduct.model.AirPortModel
PriceInfoEntityModel=ctrip.business.hotel.model.PriceInfoEntityModel
OtherUserSummaryResponse=ctrip.business.other.OtherUserSummaryResponse
FlightSpeedySettingPassengerInfoModel=ctrip.business.flight.model.FlightSpeedySettingPassengerInfoModel
ReturnTicketInfoModel=ctrip.business.train.model.ReturnTicketInfoModel
OtherNationDataSynchronizeModel=ctrip.business.other.model.OtherNationDataSynchronizeModel
OtherTrainStationDataSynchronizeResponse=ctrip.business.other.OtherTrainStationDataSynchronizeResponse
CreditCardModel=ctrip.business.payment.model.CreditCardModel
HotelKeywordAutoCompleteResponse=ctrip.business.hotel.HotelKeywordAutoCompleteResponse
FlightSpeedySearchResponse=ctrip.business.flight.FlightSpeedySearchResponse
CustomerPassengerSearchResponse=ctrip.business.system.CustomerPassengerSearchResponse
PassengerTicketInfoModel=ctrip.business.flight.model.PassengerTicketInfoModel
VacationOrderDetailInvoiceInfoModel=ctrip.business.travel.model.VacationOrderDetailInvoiceInfoModel
GroupOrderModel=ctrip.business.hotelGroup.model.GroupOrderModel
BaseDataRegionInfoModel=ctrip.business.other.model.BaseDataRegionInfoModel
FlightListSearchResponse=ctrip.business.flight.FlightListSearchResponse
HotelOrderStatusUpdateResponse=ctrip.business.hotel.HotelOrderStatusUpdateResponse
OtherFeedbackAddResponse=ctrip.business.other.OtherFeedbackAddResponse
ItineraryItemModel=ctrip.business.train.model.ItineraryItemModel
ReplyItemModel=ctrip.business.travel.model.ReplyItemModel
FlightAirportTerminalModel=ctrip.business.airportInfo.model.FlightAirportTerminalModel
GroupConditionModel=ctrip.business.hotelGroup.model.GroupConditionModel
CarRentalOrderSubmitResponse=ctrip.business.carProduct.CarRentalOrderSubmitResponse
FlightDetailBasicModel=ctrip.business.flight.model.FlightDetailBasicModel
OtherOutlandFlightSummaryModel=ctrip.business.other.model.OtherOutlandFlightSummaryModel
CustomerPassengerItemModel=ctrip.business.system.model.CustomerPassengerItemModel
VacationOrderItemModel=ctrip.business.travel.model.VacationOrderItemModel
HotelOrderItemModel=ctrip.business.hotel.model.HotelOrderItemModel
TicketResultItemModel=ctrip.business.travel.model.TicketResultItemModel
GroupCityModel=ctrip.business.hotelGroup.model.GroupCityModel
CustomerMessageItemModel=ctrip.business.system.model.CustomerMessageItemModel
AdURLModel=ctrip.business.other.model.AdURLModel
ArriveItemModel=ctrip.business.travel.model.ArriveItemModel
PriceInfoInOrderDetailModel=ctrip.business.intFlight.model.PriceInfoInOrderDetailModel
OutlandHotelOrderSubmitResponse=ctrip.business.overseas.OutlandHotelOrderSubmitResponse
IntlFlightOrderListSearchResponse=ctrip.business.intFlight.IntlFlightOrderListSearchResponse
GroupOrderDetailSearchResponse=ctrip.business.hotelGroup.GroupOrderDetailSearchResponse
RoomModel=ctrip.business.hotel.model.RoomModel
FlightStraightOrderIDGetResponse=ctrip.business.flight.FlightStraightOrderIDGetResponse
CustomerAddressSearchResponse=ctrip.business.system.CustomerAddressSearchResponse
OtherUserLoginResponse=ctrip.business.other.OtherUserLoginResponse
TimetableItemInforModel=ctrip.business.train.model.TimetableItemInforModel
GroupCommentModel=ctrip.business.hotelGroup.model.GroupCommentModel
SyncBaseDataSearchResponse=ctrip.business.other.SyncBaseDataSearchResponse
VacationPromotionModel=ctrip.business.travel.model.VacationPromotionModel
PkgFltProductInformationModel=ctrip.business.selfTravel.model.PkgFltProductInformationModel
NearbyPlaceModel=ctrip.business.hotel.model.NearbyPlaceModel
HotelDetailSearchV2Response=ctrip.business.hotel.HotelDetailSearchV2Response
CustomerConsumeModel=ctrip.business.system.model.CustomerConsumeModel
HotelBookCheckResponse=ctrip.business.hotel.HotelBookCheckResponse
FlightOnlyPaymentItemModel=ctrip.business.flight.model.FlightOnlyPaymentItemModel
FlightDetailSearchResponse=ctrip.business.flight.FlightDetailSearchResponse
FeedbackModel=ctrip.business.flight.model.FeedbackModel
PolicyInfoInDetailModel=ctrip.business.intFlight.model.PolicyInfoInDetailModel
FlightSegmentModel=ctrip.business.flight.model.FlightSegmentModel
FlightDeliveryTypeItemModel=ctrip.business.flight.model.FlightDeliveryTypeItemModel
HotelModel=ctrip.business.hotel.model.HotelModel
FlightAirportDetailSearchResponse=ctrip.business.airportInfo.FlightAirportDetailSearchResponse
CustomerFlightVarForOrderResponse=ctrip.business.system.CustomerFlightVarForOrderResponse
FlightDetailRemarkModel=ctrip.business.flight.model.FlightDetailRemarkModel
VacationKeywordSearchResponse=ctrip.business.travel.VacationKeywordSearchResponse
HotelRoomAvgPriceModel=ctrip.business.overseas.model.HotelRoomAvgPriceModel
GroupContactInformationModel=ctrip.business.hotelGroup.model.GroupContactInformationModel
PkgProHotelListInformationModel=ctrip.business.selfTravel.model.PkgProHotelListInformationModel
HotelOrderDetailSearchResponse=ctrip.business.hotel.HotelOrderDetailSearchResponse
VacationProductConsultListSearchResponse=ctrip.business.travel.VacationProductConsultListSearchResponse
WarningInfoEntityModel=ctrip.business.hotel.model.WarningInfoEntityModel
BaseDataSyncModel=ctrip.business.other.model.BaseDataSyncModel
ExtendInfoModel=ctrip.business.carProduct.model.ExtendInfoModel
TravelHotelInformationModel=ctrip.business.basic.model.TravelHotelInformationModel
HotelRoomModel=ctrip.business.overseas.model.HotelRoomModel
GroupConditionListSearchResponse=ctrip.business.hotelGroup.GroupConditionListSearchResponse
VacationTicketPriceListSearchResponse=ctrip.business.travel.VacationTicketPriceListSearchResponse
HotelOrderListSearchResponse=ctrip.business.hotel.HotelOrderListSearchResponse
PayTypeTravelTicketModel=ctrip.business.payment.model.PayTypeTravelTicketModel
PkgFltFlightListInformationModel=ctrip.business.selfTravel.model.PkgFltFlightListInformationModel
PkgHotelDetailLocationInformationModel=ctrip.business.selfTravel.model.PkgHotelDetailLocationInformationModel
FavHotelItemModel=ctrip.business.hotel.model.FavHotelItemModel
FlightOrderListSearchResponse=ctrip.business.flight.FlightOrderListSearchResponse
OtherCityDataSynchronizeResponse=ctrip.business.other.OtherCityDataSynchronizeResponse
HotelInvoiceTypeModel=ctrip.business.hotel.model.HotelInvoiceTypeModel
OtherAirlineDataSynchronizeResponse=ctrip.business.other.OtherAirlineDataSynchronizeResponse
CustomerNotificationPushResponse=ctrip.business.system.CustomerNotificationPushResponse
RoomTicketGiftInfoModel=ctrip.business.hotel.model.RoomTicketGiftInfoModel
ChannelModel=ctrip.business.travel.model.ChannelModel
RelatedGroupModel=ctrip.business.hotelGroup.model.RelatedGroupModel
FlightFullVarItemModel=ctrip.business.flight.model.FlightFullVarItemModel
BasicPriceModel=ctrip.business.selfTravel.model.BasicPriceModel
BusinessDataSyncModel=ctrip.business.other.model.BusinessDataSyncModel
OtherSubnetMaskDataSynchronizeResponse=ctrip.business.other.OtherSubnetMaskDataSynchronizeResponse
CustomerOrderEntityModel=ctrip.business.system.model.CustomerOrderEntityModel
OtherSecurityPolictyModel=ctrip.business.other.model.OtherSecurityPolictyModel
TrainTicketReturnResponse=ctrip.business.train.TrainTicketReturnResponse
FlightTaxiInformationModel=ctrip.business.airportInfo.model.FlightTaxiInformationModel
HotelInformationModel=ctrip.business.hotel.model.HotelInformationModel
TrainInsuranceProductModel=ctrip.business.train.model.TrainInsuranceProductModel
WarningInfoModel=ctrip.business.hotel.model.WarningInfoModel
PkgVacationXRoomInformationModel=ctrip.business.selfTravel.model.PkgVacationXRoomInformationModel
FlightTicketRefundResponse=ctrip.business.flight.FlightTicketRefundResponse
FlightCabinSearchResponse=ctrip.business.flight.FlightCabinSearchResponse
HotelFavorOperateResponse=ctrip.business.hotel.HotelFavorOperateResponse
GroupListSearchResponse=ctrip.business.hotelGroup.GroupListSearchResponse
HotelCommentSearchResponse=ctrip.business.hotel.HotelCommentSearchResponse
FlightTicketRefundChangeSearchResponse=ctrip.business.flight.FlightTicketRefundChangeSearchResponse
BasicTinyPriceModel=ctrip.business.selfTravel.model.BasicTinyPriceModel
TicketGiftEntityModel=ctrip.business.hotel.model.TicketGiftEntityModel
OtherZoneInforItemModel=ctrip.business.other.model.OtherZoneInforItemModel
GroupHotelSummaryModel=ctrip.business.hotelGroup.model.GroupHotelSummaryModel
FlightDeliveryTypeSearchResponse=ctrip.business.flight.FlightDeliveryTypeSearchResponse
HotelRoomBookingRuleModel=ctrip.business.overseas.model.HotelRoomBookingRuleModel
FlightLowPriceAttendResponse=ctrip.business.flight.FlightLowPriceAttendResponse
OtherTrainSummaryModel=ctrip.business.other.model.OtherTrainSummaryModel
OtherCheckInSummaryModel=ctrip.business.other.model.OtherCheckInSummaryModel
PkgOrderVacationDetailInformationModel=ctrip.business.selfTravel.model.PkgOrderVacationDetailInformationModel
OtherVacationProductDataSynchronizeModel=ctrip.business.other.model.OtherVacationProductDataSynchronizeModel
CustomerCouponModel=ctrip.business.system.model.CustomerCouponModel
HotelRoomDailyPriceModel=ctrip.business.overseas.model.HotelRoomDailyPriceModel
CustomerHotelOrderModel=ctrip.business.system.model.CustomerHotelOrderModel
VacationOrderDetailSearchResponse=ctrip.business.travel.VacationOrderDetailSearchResponse
OtherHotelSummaryModel=ctrip.business.other.model.OtherHotelSummaryModel
FlightOrderDetailSearchResponse=ctrip.business.flight.FlightOrderDetailSearchResponse
OtherCantonDataSynchronizeResponse=ctrip.business.other.OtherCantonDataSynchronizeResponse
TicketPriceItemModel=ctrip.business.travel.model.TicketPriceItemModel
AdDataModel=ctrip.business.other.model.AdDataModel
NearbyHotelModel=ctrip.business.hotel.model.NearbyHotelModel
InvoiceInformationModel=ctrip.business.hotel.model.InvoiceInformationModel
HotelRecommendListSearchResponse=ctrip.business.hotel.HotelRecommendListSearchResponse
GroupPriceModel=ctrip.business.hotelGroup.model.GroupPriceModel
TicketItemModel=ctrip.business.hotel.model.TicketItemModel
QuestionItemModel=ctrip.business.travel.model.QuestionItemModel
GroupMessageSendResponse=ctrip.business.hotelGroup.GroupMessageSendResponse
BasicImageModel=ctrip.business.hotel.model.BasicImageModel
OtherNonmemberLoginResponse=ctrip.business.other.OtherNonmemberLoginResponse
BasicContactInformationModel=ctrip.business.selfTravel.model.BasicContactInformationModel
GroupOrderUpdateResponse=ctrip.business.hotelGroup.GroupOrderUpdateResponse
IntlFlightClassCheckResponse=ctrip.business.intFlight.IntlFlightClassCheckResponse
HotelRoomGuranteeInfoModel=ctrip.business.overseas.model.HotelRoomGuranteeInfoModel
HotelHotListSearchV2Response=ctrip.business.hotel.HotelHotListSearchV2Response
VacationProductListSearchResponse=ctrip.business.travel.VacationProductListSearchResponse
OtherPushMessageClearResponse=ctrip.business.other.OtherPushMessageClearResponse
FlightFullVarItemExModel=ctrip.business.flight.model.FlightFullVarItemExModel
PkgHotelDetailCommentInformationModel=ctrip.business.selfTravel.model.PkgHotelDetailCommentInformationModel
PackageListSearchResponse=ctrip.business.selfTravel.PackageListSearchResponse
PostInfoModel=ctrip.business.train.model.PostInfoModel
FlightNoteDetailModel=ctrip.business.selfTravel.model.FlightNoteDetailModel
OtherVacationSummaryModel=ctrip.business.other.model.OtherVacationSummaryModel
AutoCompleteKeywordModel=ctrip.business.hotel.model.AutoCompleteKeywordModel
IntlFlightDeliverySearchResponse=ctrip.business.intFlight.IntlFlightDeliverySearchResponse
QueryParameterModel=ctrip.business.basic.model.QueryParameterModel
ShoppingResultInListModel=ctrip.business.intFlight.model.ShoppingResultInListModel
TrainItemInforModel=ctrip.business.train.model.TrainItemInforModel
CreditCardEntityModel=ctrip.business.hotel.model.CreditCardEntityModel
CustomerOrderItemModel=ctrip.business.system.model.CustomerOrderItemModel
IntlFlightQTESearchResponse=ctrip.business.intFlight.IntlFlightQTESearchResponse
GroupOrderListSearchResponse=ctrip.business.hotelGroup.GroupOrderListSearchResponse
CustomerRechargeModel=ctrip.business.system.model.CustomerRechargeModel
SlaveCardInformationModel=ctrip.business.basic.model.SlaveCardInformationModel
PriceItemModel=ctrip.business.travel.model.PriceItemModel
OtherAirlineDataSynchronizeModel=ctrip.business.other.model.OtherAirlineDataSynchronizeModel
PkgHotelDetailBaseInformationModel=ctrip.business.selfTravel.model.PkgHotelDetailBaseInformationModel
FlightInsuranceItemModel=ctrip.business.flight.model.FlightInsuranceItemModel
OtherAirportCityDataSynchronizeModel=ctrip.business.other.model.OtherAirportCityDataSynchronizeModel
CustomerFlightVarItemModel=ctrip.business.system.model.CustomerFlightVarItemModel
HotelRoomGuranteeInformationModel=ctrip.business.hotel.model.HotelRoomGuranteeInformationModel
FlightDetailPromptModel=ctrip.business.flight.model.FlightDetailPromptModel
TrainOrderDetailItemModel=ctrip.business.train.model.TrainOrderDetailItemModel
BasicDeliverySiteModel=ctrip.business.selfTravel.model.BasicDeliverySiteModel
HotelDetailSearchResponse=ctrip.business.hotel.HotelDetailSearchResponse
FlightSearchResponseInfoModel=ctrip.business.intFlight.model.FlightSearchResponseInfoModel
OtherHotelHotDataSynchronizeResponse=ctrip.business.other.OtherHotelHotDataSynchronizeResponse
ArrivalTimeInfoModel=ctrip.business.hotel.model.ArrivalTimeInfoModel
IntlFlightListSearchResponse=ctrip.business.intFlight.IntlFlightListSearchResponse
OrderDetailProductItemModel=ctrip.business.travel.model.OrderDetailProductItemModel
GroupImageModel=ctrip.business.hotelGroup.model.GroupImageModel
CustomerCreditCardItemModel=ctrip.business.system.model.CustomerCreditCardItemModel
ThirdPayPackageModel=ctrip.business.payment.model.ThirdPayPackageModel
CustomerTravelTicketSearchResponse=ctrip.business.system.CustomerTravelTicketSearchResponse
HotelListSearchV2Response=ctrip.business.hotel.HotelListSearchV2Response
VacationCommentItemModel=ctrip.business.travel.model.VacationCommentItemModel
FlightDetailPolicyModel=ctrip.business.flight.model.FlightDetailPolicyModel
PolicyInfoInListModel=ctrip.business.intFlight.model.PolicyInfoInListModel
TrainOrderDetailSearchResponse=ctrip.business.train.TrainOrderDetailSearchResponse
PkgHotelDetailActiveInformationModel=ctrip.business.selfTravel.model.PkgHotelDetailActiveInformationModel
